##########@#...#.#
#..#.#...#.#...#.#
#........#.#####.#
#..#.#...........#
##################